1111111111111111111111111111111111111111111111111111111111111111111111111111111111111111111111111
100MEC0000000000000000000000000000000000000000000000000000000000000000000000000000000000000000001
10000M0000000000000000000000000000000000000000000000000000000000000000000000000000000000000000001
1000001000000000000000000000000000000000000000000000000000000000000000000000000000000000000000001
1000001000000000000000000000000000000000000000000000000000000000000000000000000000000000000000001
1000001000000000000000000000000000000000000000000000000000000000000000000000000000000000000000001
1000000000000000000000000000000000000000000000000000000000000000000000000000000000000000000000001
1000001000000000000000000000000000000000000000000000000000000000000000000000000000000000000000001
1000001000000000000000000000000000000000000000000000000000000000000000000000000000000000000000001
1000001000000000000000000000000000000000000000000000000000000000000000000000000000000000000000001
1000001000000000000000000000000000000000000000000000000000000000000000000000000000000000000000011
1000001000000000000000000000000000000000000000000000000000000000000000000000000000000000000000001
1P00001000000000000000000000000000000000000000000000000000000000000000000000000000000000000000001
1000001000000000000000000000000000000000000000000000000000000000000000000000000000000000000000001
1C00001000000000000000000000000000000000000000000000000000000000000000000000000000000000000000001
1111111111111111111111111111111111111111111111111111111111111111111111111111111111111111111111111