11111111111111111111111111111111111
1000000000000000000C0000000C00C0001
10C0000C0000C00000000C00000C0CC00C1
10C0C0000000C000000000000C000C00001
1C0000000C000000000CC0000000C000001
1C0000000C000000000CC0000000C000001
11111111111111111111111111111111111
