1111
1001
1001
1001
1001
1001
1001
1001
1001
1001
1001
1001
1001
1001
1001
1001
1001
1001
1001
1001
1001
1001
1P01
1001
1001
1001
1C01
1001
10E1
1001
1111