1111
1M01
10E1
10M1
1001
1001
1001
1M01
1001
1001
1001
10C1
1001
1001
10P1
1111