111111111111111111111111111
10000000000E00000C00C00M001
1000C0C0000C00M000010000CC1
10C00000M000000M0001C00C001
10P000C000000000CC010000001
111111111111111111111111111
