11111111111111111111111111111111111
10000CC0000000CC01000C0000000000001
100000000CC0E0000100C000C000C0000C1
1000C00000CC00000100000C000C00C0001
1000C00000CC00000100000C000C00C0001
10000000000000000100C000C0C00P00001
11111111111111111111111111111111111
