11111111111111111111111111111111111
1C000000000000CC000000C000C000P0001
1000001C0101000CC00C00100000000C001
10000010010010E000100010000000C0001
10000010010000CC0000C010C00C000C001
11111111111111111111111111111111111
