111111111111111111111111111
10000000100E00000C00C00M001
1000C0C0100C00M000010000CC1
10C00000M010010M0001C00C001
10P000C000100100CC010000001
111111111111111111111111111
