1111111
100MEC1
10000M1
1000001
1000001
1000001
1000001
1000001
1000001
1000001
1000001
1000001
1P00001
1000001
1C00001
1111111