11111111111111111111111111111111111
10000000000E00000C00C00000C00C0C001
1000C0C0000C0000000C0000CC0000000C1
10C00000C00000000000C00C0C0000C0001
1P0000C000000000CC00000000000000001
11111111111111111111111111111111111
