11111111111111111111111111111111111
1C000000000000CC000000C000C000PC001
10000C0C000C000CC00C00000000000C001
10000000000000E000000000000000C0001
10000000C00000CC0000C000C00C000C001
11111111111111111111111111111111111
