00000000000000000000000000000000000
0000000000000000C0C00000C00000000C0
0000000C00P0C00000000CC0000C0000000
000000000000000C00C000000C00000C0C0
0CC0E0000000000CC000C0000000000C0C0
00000000000000000000000000000000000
